1111111111111111111111111111111
1111111111111111111111111111111
0011111111111111111111111111111
0000001111111111111111111111111
0000000000111111111111111111111
0000000000000000000000000000000
0000000000000000000000000000000
0000000000000000000000000000000
0000000000000000000000000000000
0000000000000000000000000000000
0000000000000000000000000000000
0000000000000000000000000000000
0000000000000000000000000000000
2000000000000000000000000000000
2200000000000000000000000000000
0220000000000000000000000000000
0022000000000000000000000000000
0002200000000000000000000000000
