11111111111111111111111111111111111111111111111111111111111111
11111111111111111111111111111111111111111111111111111111111111
00111111111111111111111111111110011111111111111111111111111111
00000011111111111111111111111110000001111111111111111111111111
00000000001111111111111111111110000000000111111111111111111111
00000000000000000000000000000000000000000000000000000000000000
00000000000000000000000000000000000000000000000000000000000000
00000000000000000000000000000000000000000000000000000000000000
00000000000000000000000000000000000000000000000000000000000000
00000000000000000000000000000000000000000000000000000000000000
00000000000000000000000000000000000000000000000000000000000000
00000000000000000000000000000000000000000000000000000000000000
00000000000000000000000000000000000000000000000000000000000000
20000000000000000000000000000000000000000000000000000000000000
22000000000000000000000000000000000000000000000000000000000000
02200000000000000000000000000000000000000000000000000000000000
00220000000000000000000000000000000000000000000000000000000000
00022000000000000000000000000000000000000000000000000000000000
11111111111111111111111111111111111111111111111111111111111111
11111111111111111111111111111111111111111111111111111111111111
00111111111111111111111111111110011111111111111111111111111111
00000011111111111111111111111110000001111111111111111111111111
00000000001111111111111111111110000000000111111111111111111111
00000000000000000000000000000000000000000000000000000000000000
00000000000000000000000000000000000000000000000000000000000000
00000000000000000000000000000000000000000000000000000000000000
00000000000000000000000000000000000000000000000000000000000000
00000000000000000000000000000000000000000000000000000000000000
00000000000000000000000000000000000000000000000000000000000000
00000000000000000000000000000000000000000000000000000000000000
00000000000000000000000000000000000000000000000000000000000000
20000000000000000000000000000000000000000000000000000000000000
22000000000000000000000000000000000000000000000000000000000000
02200000000000000000000000000000000000000000000000000000000000
00220000000000000000000000000000000000000000000000000000000000
00022000000000000000000000000000000000000000000000000000000000
