1111111111111111111111111111111111111111111111
1111111111111111111111111111111111111111111111
0011111111111111111111111111111111111111111100
0000001111111111111111111111111111111111000000
0000000000111111111111111111111111110000000000
0000000000000000000000000000000000000000000000
0000000000000000000000000000000000000000000000
0000000000000000000000000000000000000000000000
0000000000000000000000000000000000000000000000
0000000000000000000000000000000000000000000000
0000000000000000000000000000000000000002200000
0000000000000000000000000000000000000222222000
0000000000000000000000000000000000222222222202
2000000000000000000000000000000000000222222222
2200000000000000000000000000000000002222222222
0220000000000000000000000000000000022222222222
0022000000000000000000000000000000000222222222
0002200000000000000000000000000000000000222222
0002200000000000000000000000000000000000000022
0000220000000000000000000000000000000000000000
0000220000000000000000000000000000000000000000
0022200000000000000000000000000000000000000000
0220020000000000000000000000000000000000000000
2200002000000000000000000000000000000000000000
0000020000000000000000000000000000000000000000
